21
4444444444444444444
4000001721111000204
4111101010010101114
4020101010000070004
4000100010000011104
4000701000111111004
4011111000120700004
4011111111111111114
4010000000007001004
4710111111111101014
4010111111121121004
4012000000001101114
4011111111111101104
4000000000000001274
4111111110111111114
4021110217100111004
4000000010100000004
4171111100000111004
4000000000001127014
4101111100001111704
4444444444444444444
11