21
4444444444444444444
4010002000011111724
4010111110000110014
4012100000110000014
4010100010000111014
4210100100110000004
4010100001000111114
4010170110011100004
4010121100000000014
4710111100111011004
4010100700000000014
4010112011117011004
4010111110000000714
4010120000000211024
4010111100011111114
4010121000000000704
4010170011111101104
4010110010011100104
4010100110011100174
4700102010011100004
4444444444444444444
11