21
4444444444444444444
4001111111111111114
4000000001000000024
4111111101000001114
4000002701021100004
4011111111000100004
4072000001110111104
4111111101020111104
4211270101111100004
4000010100070000014
4111110001110011004
4000070100011110014
4020110011111111004
4111110000000000014
4111111117111111114
4020700000200000004
4111100000011111004
4270000111100000004
4111100000000011114
4000071110000070204
4444444444444444444
12