21
4444444444444444444
4000007000000000004
4111111100011111114
4111111100011111114
4200070000000000004
4000111111100707074
4000111111111212124
4000000000021111114
4111111111171111114
4007100000000000004
4010100000110000004
4010100000111111114
4010100000110000024
4010100000110000024
4010000200117111114
4010101110110000024
4010101110110111114
4010101110117111114
4210101110002000704
4010101110111111104
4444444444444444444
11