21
4444444444444444444
4001000000010070024
4001201001110001104
4001111002110011004
4107000701110100004
4111011111007120004
4001000100000111004
4201000000000011104
4001111100110000104
4001100100001100104
4007000111100100104
4111100002101100114
4000100001101000004
4020102000021000004
4000111111111001114
4000701110000000014
4111100001111110014
4020100111072010004
4711100010001111114
4000000000000000704
4444444444444444444
11